111111111
1110P0001
111000001
111000001
11100E001
1CCCCCCC1
111111111