11111111111111111111111111111111111111111111111111111111111111111111111111111111111111111
1000000000000000E00000000C000000000000000000010000000000001111111111111111111111111111111
1P000000000000000000000000000000000000000000010000000000000011111111111111111111111111111
11111111111111111111111111111111111111111111111111111111111111111111111111111111111111111