111111111111
100000100001
100P001E0001
1C0000100001
1CCCCC100001
111111111111