111111111111111111111
1000000P0000000000001
100000000000000000001
10000CCCCCCCCCCCCC001
100000000000000000001
111110000000000000001
100000000000000000001
1000000CCCCCCCC000001
1000000000000E00M0001
100000CCCCCCCCC00C001
100000000000000000001
111111111111111111111
