11111111111111111111111111111111
1111111C111111111111111111111111
11111110111C11111111111111111111
11111C0000000000000000000C111111
11111011111111111111111111111111
1110C000111111111111111111111111
111P000000CE000000000M1111111111
11111011111111111111111111111111
11111000000000000CCCC11111111111
11111111111111111111111111111111
