1111111111111111111111111111111111111111111111111111111111111111111111111111
1000000000000000E00000000C00000000000111111111111111111111111111111111111111
1P00000000000000000000000000000000000111111111111111111111111111111111111111
1111111111111111111111111111111011111111111111111111111111111111111111111111
1111111111111111111111111111111011111111111111111111111111111111111111111111
1111111111111111111111111111111011111111111111111111111111111111111111111111
1111111111111111111111111111111011111111111111111111111111111111111111111111
1111111111111111111111111111111011111111111111111111111111111111111111111111
1111111111111111111111111111111011111111111111111111111111111111111111111111
1111111111111111111111111111111011111111111111111111111111111111111111111111
1111111111111111111111111111111011111111111111111111111111111111111111111111
1000000000000000000000000000000000000111111111111111111111111111111111111111
100000000000000000000M000000000000000111111111111111111111111111111111111111
1000000000000000000000000000000000000111111111111111111111111111111111111111
1000000000000000000000000000000000000111111111111111111111111111111111111111
1000000000000000000000000000000000000111111111111111111111111111111111111111
1000000000000000000000000000000000000111111111111111111111111111111111111111
1000000000000000000000000000000000000111111111111111111111111111111111111111
1000000000000000000000000000000000000111111111111111111111111111111111111111
1111111111111111111111111011111111111111111111111111111111111111111111111111
1111111111111111111111111011111111111111111111111111111111111111111111111111
1111111111111111111111111011111111111111111111111111111111111111111111111111
1111111111111111111111111111111111111111111111111111111111111111111111111111
