111111111111
1000000000C1
100P000E00C1
1C00000000C1
1CCCCCCCCCC1
111111111111